11111111111111111111111111
10000000000000000000000001
10000000C00000000000000001
1000100000000000C000000001
10C00000000E00000000000001
1000000000000P0000C0000001
10C00000000000000000000001
100001111111110000000C0001
100000000000000C0000000001
11111111111111111111111111